いせき	伊籍	人名
うきん	于禁	人名
えいかん	衛カン	人名
えんき	袁熙	人名
えんき	袁姫	人名
えんしょう	袁尚	人名
えんしょう	袁紹	人名
えんじゅつ	袁術	人名
えんほ	閻圃	人名
おうい	王異	人名
おういん	王允	人名
おうきょう	王匡	人名
おうげんき	王元姫	人名
おうしゅん	王濬	人名
おうそう	王双	人名
おうへい	王平	人名
おうほ	王甫	人名
おうろう	王朗	人名
かいえつ	カイ越	人名
かき	賈逵	人名
かぎ	何儀	人名
かく	賈ク	人名
かくえき	郭奕	人名
かくか	郭嘉	人名
かくきひ	郭貴妃	人名
かくし	郭シ	人名
かくしょう	カク昭	人名
かくと	郭図	人名
かくぼう	カク萌	人名
かくわい	郭淮	人名
かこうい	夏侯威	人名
かこうえい	夏侯栄	人名
かこうえん	夏侯淵	人名
かこうおん	夏侯恩	人名
かこうげん	夏侯玄	人名
かこうごう	何皇后	人名
かこうし	夏候氏	人名
かこうしょう	夏侯尚	人名
かこうとん	夏侯惇	人名
かこうは	夏候覇	人名
かこうぼう	夏侯楙	人名
かじゅう	賈充	人名
かしん	何進	人名
かてい	カ定	人名
かゆう	華雄	人名
かんう	関羽	人名
かんきゅうけん	カン丘倹	人名
かんぎんぺい	関銀屏	人名
かんこう	関興	人名
かんこう	韓浩	人名
かんさく	関索	人名
かんすい	韓遂	人名
かんたく	カン沢	人名
かんとう	韓当	人名
かんねい	甘寧	人名
かんふじん	甘夫人	人名
かんぺい	関平	人名
かんよう	簡ヨウ	人名
がくしん	楽進	人名
がくちん	楽チン	人名
がせい	賀斉	人名
がんりょう	顔良	人名
きゅうけん	丘建	人名
きょうい	姜維	人名
きょうと	キョウ都	人名
きょぎ	許儀	人名
きょちょ	許チョ	人名
きょゆう	許攸	人名
きれい	紀霊	人名
ぎえん	魏延	人名
ぎしさい	戯志才	人名
ぎぞく	魏続	人名
ぎふう	魏諷	人名
ぎゅうきん	牛金	人名
ぐほん	虞翻	人名
けいあいこうごう	敬哀皇后	人名
げんがん	厳顔	人名
げんし	厳氏	人名
げんせい	厳政	人名
げんはくこ	厳白虎	人名
こうがい	黄蓋	人名
こうけん	黄権	人名
こうげつえい	黄月英	人名
こうこう	黄皓	人名
こうしょう	高翔	人名
こうしょう	高昇	人名
こうじゅん	高順	人名
こうせい	候成	人名
こうせん	候選	人名
こうそ	黄祖	人名
こうそんさん	公孫サン	人名
こうそんど	公孫度	人名
こうそんはん	公孫範	人名
こうちゅう	黄忠	人名
こうほすう	皇甫嵩	人名
こうゆう	孔融	人名
こうらん	高覧	人名
こえん	胡淵	人名
こしつ	胡質	人名
こしゃじ	胡車児	人名
こじゅん	胡遵	人名
こふん	胡奮	人名
こよう	顧雍	人名
これつ	胡烈	人名
ごい	呉懿	人名
ごきょ	呉巨	人名
ごけい	呉景	人名
ごつとつこつ	兀突骨	人名
ごはん	呉班	人名
ごらん	呉蘭	人名
さいぶんき	蔡文姫	人名
さいぼう	蔡瑁	人名
さじ	左慈	人名
しさん	師纂	人名
しばい	司馬懿	人名
しばえん	司馬炎	人名
しばし	司馬師	人名
しばしょう	司馬昭	人名
しゃまか	沙摩柯	人名
しゅい	朱異	人名
しゅうき	周姫	人名
しゅうこう	周昂	人名
しゅうそう	周倉	人名
しゅうたい	周泰	人名
しゅうほう	周魴	人名
しゅうゆ	周瑜	人名
しゅかん	朱桓	人名
しゅしゅん	朱儁	人名
しゅぜん	朱然	人名
しゅち	朱治	人名
しゅれい	朱霊	人名
しょうえん	蒋エン	人名
しょうかい	鍾会	人名
しょうきょう	小喬	人名
しょうきん	蒋欽	人名
しょうぎきょ	蒋義渠	人名
しょうちょう	向寵	人名
しょうよう	鍾ヨウ	人名
しょかつかく	諸葛恪	人名
しょかつきん	諸葛瑾	人名
しょかつせん	諸葛セン	人名
しょかつたん	諸葛誕	人名
しょかつりょう	諸葛亮	人名
しょくゆう	祝融	人名
しんき	甄姫	人名
しんけんえい	辛憲英	人名
しんぱい	審配	人名
しんぴ	辛毘	人名
しんろう	秦朗	人名
じゅんいく	荀彧	人名
じゅんうけい	淳于瓊	人名
じゅんゆう	荀攸	人名
じょえい	徐栄	人名
じょこう	徐晃	人名
じょし	徐氏	人名
じょしつ	徐質	人名
じょしょ	徐庶	人名
じょせい	徐盛	人名
すうし	鄒氏	人名
すうせい	鄒靖	人名
せいか	成何	人名
せいぎ	成宜	人名
せいこうえい	成公英	人名
ぜんそう	全ソウ	人名
そうあんみん	曹安民	人名
そうえい	曹叡	人名
そうきゅう	曹休	人名
そうけん	宋憲	人名
そうこう	曹昂	人名
そうこう	曹洪	人名
そうこうごう	曹皇后	人名
そうしょう	曹彰	人名
そうしょく	曹植	人名
そうしん	曹真	人名
そうじゅん	曹純	人名
そうじん	曹仁	人名
そうそう	曹操	人名
そうそう	曹爽	人名
そうひ	曹丕	人名
そうひょう	曹豹	人名
そじゅ	沮授	人名
そも	祖茂	人名
そんかん	孫カン	人名
そんけん	孫乾	人名
そんけん	孫堅	人名
そんけん	孫権	人名
そんこう	孫皎	人名
そんさく	孫策	人名
そんしゅん	孫峻	人名
そんしょう	孫韶	人名
そんしょうこう	孫尚香	人名
そんせい	孫静	人名
そんちん	孫チン	人名
そんゆ	孫瑜	人名
そんよく	孫ヨク	人名
そんりょう	孫亮	人名
そんれい	孫礼	人名
そんろいく	孫魯育	人名
そんろはん	孫魯班	人名
ぞうは	臧覇	人名
たいしきょう	太史享	人名
たいしじ	太史慈	人名
たいらいどうしゅ	帯来洞主	人名
だいきょう	大喬	人名
だしだいおう	朶思大王	人名
ちょういん	張允	人名
ちょううん	趙雲	人名
ちょうえん	張燕	人名
ちょうかく	張角	人名
ちょうぎょく	張嶷	人名
ちょうくん	張勲	人名
ちょうこ	張虎	人名
ちょうこう	張コウ	人名
ちょうこう	張紘	人名
ちょうこう	趙弘	人名
ちょうこうごう	張皇后	人名
ちょうさい	張済	人名
ちょうしゅう	張繍	人名
ちょうしゅんか	張春華	人名
ちょうしょう	張昭	人名
ちょうしょうほ	張昌蒲	人名
ちょうじん	張任	人名
ちょうせん	貂蝉	人名
ちょうなん	張南	人名
ちょうばく	張バク	人名
ちょうひ	張飛	人名
ちょうほう	張苞	人名
ちょうほう	張宝	人名
ちょうまんせい	張蔓成	人名
ちょうよう	張楊	人名
ちょうよく	張翼	人名
ちょうりょう	張遼	人名
ちょうりょう	張梁	人名
ちょうるい	趙累	人名
ちょうろ	張魯	人名
ちんきゅう	陳宮	人名
ちんぐん	陳グン	人名
ちんけい	陳珪	人名
ちんしょく	陳式	人名
ちんたい	陳泰	人名
ちんとう	陳登	人名
ちんぶ	陳武	人名
ちんらん	陳蘭	人名
ていいく	程昱	人名
ていえんし	程遠志	人名
ていげん	丁原	人名
ていふ	程普	人名
ていふじん	丁夫人	人名
ていほう	丁奉	人名
てんい	典韋	人名
でんぽう	田豊	人名
とういん	董允	人名
とういん	滕胤	人名
とうがい	鄧艾	人名
とうけん	鄧賢	人名
とうけん	陶謙	人名
とうし	鄧芝	人名
とうしゅう	董襲	人名
とうしょう	董昭	人名
とうしょう	董承	人名
とうたく	董卓	人名
とうちゅう	鄧忠	人名
とうとな	董荼那	人名
とうはく	董白	人名
とうも	鄧茂	人名
どよ	杜預	人名
はいげんしょう	裴元紹	人名
はさい	波才	人名
はんしょう	潘璋	人名
はんちゅう	樊稠	人名
ばがん	馬玩	人名
ばきゅう	馬休	人名
ばしょく	馬謖	人名
ばたい	馬岱	人名
ばちゅう	馬忠	人名
ばちょう	馬超	人名
ばてつ	馬鉄	人名
ばとう	馬騰	人名
ばりょう	馬良	人名
ひい	費イ	人名
びじく	麋竺	人名
びふじん	麋夫人	人名
びほう	麋芳	人名
ふうしゅう	馮習	人名
ふしじん	傳士仁	人名
ふせん	傳僉	人名
ふとう	傳トウ	人名
ぶんおう	文鴦	人名
ぶんきん	文欽	人名
ぶんしゅう	文醜	人名
ぶんぺい	文聘	人名
べんし	卞氏	人名
ほうぎ	ホウ羲	人名
ほうさんじょう	鮑三娘	人名
ほうしん	鮑信	人名
ほうせい	法正	人名
ほうとう	ホウ統	人名
ほうとく	ホウ徳	人名
ほしつ	歩隲	人名
ほふじん	歩夫人	人名
ぼくろだいおう	木鹿大王	人名
まんちょう	満寵	人名
もうかく	孟獲	人名
もうたつ	孟達	人名
もうゆう	孟優	人名
ようぎ	楊儀	人名
ようこ	羊コ	人名
ようしゅう	楊修	人名
ようほう	楊鋒	人名
らいどう	雷銅	人名
りい	李異	人名
りかい	李恢	人名
りかく	李カク	人名
りくこう	陸抗	人名
りくそん	陸遜	人名
りげん	李厳	人名
りじゅ	李儒	人名
りつう	李通	人名
りてん	李典	人名
りゅうき	劉キ	人名
りゅうきょう	劉協	人名
りゅうくん	劉勲	人名
りゅうしょう	劉璋	人名
りゅうぜん	劉禅	人名
りゅうは	劉巴	人名
りゅうひょう	劉表	人名
りゅうび	劉備	人名
りゅうふじん	劉夫人	人名
りゅうへき	劉辟	人名
りゅうほう	劉封	人名
りゅうよう	劉曄	人名
りゅうよう	劉ヨウ	人名
りょうか	廖化	人名
りょうこう	梁興	人名
りょうそう	凌操	人名
りょうとう	凌統	人名
りょき	呂姫	人名
りょたい	呂岱	人名
りょはん	呂範	人名
りょふ	呂布	人名
りょもう	呂蒙	人名
れいほう	冷苞	人名
ろしゅく	廬植	人名
ろしゅく	魯粛	人名
